level 1

##########
#-------X#
#-###-####
#--------#
##########

P: 8,3
C: 5,2

end

level 2

#########
#------X#
#-------#
#------X#
#########

P: 1,2
C: 5,2 5,3

end
