level 1

   #####
####--X-#
#-------#
####---X#
   #####

P: 1,2
C: 5,2

end